|---MAP: ISOLATED------------------------------------------------|
|                                                                |
|  |---------------|                        |----------------|   |
|  |...............|                        |................|   |
|  |...............|                        |................|   |
|  |...............|                        |................|   |
| #+...............|                        |................+#  |
| #|...............|                        |................|#  |
| #|...............|                        |................|#  |
| #|...............|                        |................|#  |
| #|------+--------|                        |----------------|#  |
| #       #                                                   #  |
| #|------+--------|                        |----------------|#  |
| #|...............|                        |................|#  |
| #|...............|                        |................|#  |
| #|...............|                        |................|#  |
| #|...............|########################+................|#  |
| #|...............|#                       |................|#  |
| #|...............|#                       |................|#  |
| #|...............|#                       |................|#  |
| #|------+--------|#                       |--------+-------|#  |
| #       #         #                                #        #  |
| #|------+--------|#                       |--------+-------|#  |
| #|...............|#                       |................|#  |
| #|...............|#                       |................|#  |
| #|...............|#                       |................|#  |
| #|...............+#                       |................|#  |
| #|...............|                        |................|#  |
| #|...............|                        |................|#  |
| #|...............|                        |................|#  |
| #|---------------|                        |----------------|#  |
| #############################################################  |
|----------------------------------------------------------------|
